MOVES 7
START 6 4
SUCCESS 4 0
1 1 1 1 0 1 1 1
1 0 0 0 0 0 0 1
1 0 3 0 2 0 3 1
1 0 1 2 0 2 0 1
1 0 0 0 3 0 0 1
1 1 1 1 1 1 1 1
