MOVES 6
START 3 4
SUCCESS 4 0
1 1 1 1 0 1 1 1
1 0 0 3 0 0 0 1
1 0 0 0 0 0 0 1
1 0 0 0 0 0 0 1
1 0 0 0 0 0 0 1
1 1 1 1 1 1 1 1
