MOVES 7
START 1 4
SUCCESS 7 2
1 1 1 1 1 1 1 1
1 2 2 2 2 3 0 1
1 0 1 0 0 0 0 0
1 0 1 0 0 0 0 1
1 0 0 0 0 0 0 1
1 1 1 1 1 1 1 1