MOVES 6
START 5 4
SUCCESS 2 0
1 1 0 1 1 1 1 1
1 0 0 0 0 0 0 1
1 1 0 0 0 0 0 1
1 1 0 1 0 0 1 1
1 0 0 0 0 0 1 1
1 1 1 1 1 1 1 1
