MOVES 7
START 1 4
SUCCESS 1 0
1 0 1 1 1 1 1 1
1 0 0 0 0 0 0 1
1 0 1 0 1 0 1 1
1 1 0 0 1 0 0 1
1 0 0 0 0 0 0 1
1 1 1 1 1 1 1 1
