MOVES 7
START 1 4
SUCCESS 7 2
1 1 1 1 1 1 1 1
1 0 0 0 0 2 0 1
1 0 3 3 0 0 0 0
1 0 2 2 2 0 0 1
1 0 0 3 0 0 2 1
1 1 1 1 1 1 1 1