MOVES 7
START 2 4
SUCCESS 5 0
1 1 1 1 1 0 1 1
1 0 0 0 0 0 0 1
1 0 3 0 0 0 0 1
1 0 0 0 2 0 0 1
1 0 0 0 0 0 0 1
1 1 1 1 1 1 1 1