MOVES 7
START 1 1
SUCCESS 4 0
1 1 1 1 0 1 1 1
1 0 0 0 3 0 0 1
1 0 1 1 3 0 0 1
1 0 1 1 3 0 0 1
1 0 0 3 0 0 0 1
1 1 1 1 1 1 1 1