MOVES 7
START 1 2
SUCCESS 0 4
1 1 1 1 1 1 1 1
1 1 0 1 1 0 1 1
1 0 0 2 3 0 0 1
1 1 0 3 1 0 1 1
0 0 0 0 0 0 1 1
1 1 1 1 1 1 1 1
