START 5 4
SUCCESS 3 4
1 1 0 1 1 1 1 1
1 0 0 0 0 0 0 1
1 1 0 0 0 0 0 1
1 1 0 1 0 0 1 1
1 0 0 0 0 0 1 1
1 1 1 1 1 1 1 1
