MOVES 7
START 6 3
SUCCESS 2 0
1 1 0 1 1 1 1 1
1 0 0 0 1 0 0 1
1 0 0 2 0 0 0 1
1 0 0 0 0 2 0 1
1 0 1 0 0 0 0 1
1 1 1 1 1 1 1 1