MOVES 6
START 6 4
SUCCESS 3 0
1 1 1 0 1 1 1 1
1 0 0 0 0 0 1 1
1 0 3 0 0 0 0 1
1 0 0 0 0 0 0 1
1 0 0 0 0 0 0 1
1 1 1 1 1 1 1 1